%%%%%%%%%%%%%%%%%%%%%%%%%%%%%%
%.     %% .    %   P%        %
% %%%  %%      % % .%%% %%   %
%   % P   %%%%%% %  % %  %  .%
%   % .      . % %.      %%%%%
%%%%% %%%%%%   %%%%%%%       %
%.    % .% %  %%     .   %%% %
%        % %  P%   %%%%%%%.  %
% %%%%%% %    %%%% %     % %%%
%.%      %%%       %.      %.%
% %  %%%%%   %%%%  %%%%%%. % %
%       .  %. %     .        %
%%%%%%%%%%%%%%%%%%%%%%%%%%%%%%
