%%%%%%%%%%%%%%%%%%%%%%%%%%%%%%
%.     %% .    %    %        %
% %%%  %%      % % .%%% %%   %
%   % P   %%%%%% %  % %  %  .%
%   % .      . % %.    P %%%%%
%%%%% %%%%%%   %%%%%%%       %
%.    % .% %  %%     .   %%% %
%        % %   %   %%%%%%%.  %
% %%%%%% %    %%%% %     % %%%
%.%      %%%       %.     P%.%
% %  %%%%%   %%%%  %%%%%%. % %
%       .  %. %     .        %
%%%%%%%%%%%%%%%%%%%%%%%%%%%%%%
