%%%%%%%%%%%%%%%%%%%%%%%%%%%%%%%%%%%%%%%%%%%%%%%%%
% .  %        .%  P % %      %  .%     % %   %  %
%    %%%% %%%%%% %  % % %%   %     %%%%% %. %%% %
%    %.%    % .% %  % %  %   %   %         P%   %
%   .            %.     %%%% %   %% .%%% %      %
% %%%%% %%%%%%  %%%% %%          .%    %. %%%%%%%
%.      %   .%       .% %%%  % %%%%  % %  %   % %
%%% %%  % %%%%%%% %%%%% %    % %. %% % %    %.% %
%    %  %      %  %      P%%%% %     % % %%%% % %
%       %   %  %  %     %      %  %% %     .%   %
%%% %%%   .%%%    %%%%% %%% %% %  %.%%%%%%%%%%% %
%.  %    %    %              %    %             %
%%%%%%%%%%%%%%%%%%%%%%%%%%%%%%%%%%%%%%%%%%%%%%%%%