%%%%%%%%%%%%%%%%%%%%%%%%%%%%%%%%%%%%%
%                                   %
%%%%%%%%%                           %
%       %                           %
%     %.%                           %
%     %%%                           %
%                                   %
%             P                     %
%                                   %
%                                   %
%                                   %
%                           .       %
%       .                           %
%                                   %
%                                   %
%                                   %
%                                   %
%                           %%%%%%%%%
%                                  P%
%%%%%%%%%%%%%%%%%%%%%%%%%%%%%%%%%%%%%
