%%%%%%%%%%%%%%%%%%%%%%%%%%%%%%%%%%%%%
%    .              P              .%
%%%%%%%%%                           %
%       %                           %
%      .%                           %
%       %                           %
%                              .    %
%             P                     %
%   .                               %
%                                   %
%                                   %
%                           .       %
%       .                           %
%                                   %
%                                   %
%                                   %
%     .                            .%
%                           %%%%%%%%%
% .                                P%
%%%%%%%%%%%%%%%%%%%%%%%%%%%%%%%%%%%%%
